WWWWWWWWWWWWWWWWWWWWWWWWWWWWWWWWWWWWWWWWWWWWWW
WWWWWWWWWWWWWWWWWWWWWWWWWWWWWWWWWWWWWWWWWWWWWW
WWGGGGGGWWGGGGGGGGGGGGGGGGGGWWGGGGGGGGGGWWGGWW
WWGSGGGGWWGGGGGGGGGGGGGGGGGGWWGGGGGGGGGGWWGGWW
WWGGWWGGWWGGWWWWWWWWWWGGWWGGWWWWWWGGWWGGWWGGWW
WWGGWWGGWWGGWWWWWWWWWWGGWWGGWWWWWWGGWWGGWWGGWW
WWGGWWGGGGGGWWGGWWGGGGGGWWGGGGGGGGGGWWGGGGGGWW
WWGGWWGGGGGGWWGGWWGGGGGGWWGGGGGGGGGGWWGGGGGGWW
WWGGWWWWWWWWWWGGWWGGWWWWWWWWWWWWWWWWWWWWWWWWWW
WWGGWWWWWWWWWWGGWWGGWWWWWWWWWWWWWWWWWWWWWWWWWW
WWGGGGGGWWGGGGGGWWGGGGGGWWGGGGGGWWGGGGGGGGGGWW
WWGGGGGGWWGGGGGGWWGGGGGGWWGGGGGGWWGGGGGGGGGGWW
WWWWWWGGWWWWWWGGWWWWWWGGWWGGWWGGWWGGWWWWWWGGWW
WWWWWWGGWWWWWWGGWWWWWWGGWWGGWWGGWWGGWWWWWWGGWW
WWGGWWGGWWGGGGGGWWGGWWGGGGGGWWGGGGGGWWGGGGGGWW
WWGGWWGGWWGGGGGGWWGGWWGGGGGGWWGGGGGGWWGGGGGGWW
WWGGWWGGWWGGWWGGWWGGWWWWWWWWWWWWWWWWWWGGWWGGWW
WWGGWWGGWWGGWWGGWWGGWWWWWWWWWWWWWWWWWWGGWWGGWW
WWGGWWGGGGGGWWGGGGGGWWGGGGGGGGGGGGGGWWGGWWGGWW
WWGGWWGGGGGGWWGGGGGGWWGGGGGGGGGGGGGGWWGGWWGGWW
WWGGWWWWWWWWWWWWWWGGWWGGWWWWWWWWWWGGWWGGWWWWWW
WWGGWWWWWWWWWWWWWWGGWWGGWWWWWWWWWWGGWWGGWWWWWW
WWGGGGGGGGGGGGGGGGGGWWGGWWGGGGGGGGGGWWGGGGGGWW
WWGGGGGGGGGGGGGGGGGGWWGGWWGGGGGGGGGGWWGGGGGGWW
WWGGWWWWWWWWWWWWWWWWWWGGWWGGWWWWWWWWWWWWWWGGWW
WWGGWWWWWWWWWWWWWWWWWWGGWWGGWWWWWWWWWWWWWWGGWW
WWGGWWGGGGGGGGGGWWGGGGGGWWGGGGGGGGGGGGGGWWGGWW
WWGGWWGGGGGGGGGGWWGGGGGGWWGGGGGGGGGGGGGGWWGGWW
WWGGWWWWWWGGWWGGWWWWWWGGWWWWWWWWWWWWWWWWWWGGWW
WWGGWWWWWWGGWWGGWWWWWWGGWWWWWWWWWWWWWWWWWWGGWW
WWGGWWGGGGGGWWGGGGGGGGGGWWGGGGGGGGGGGGGGWWGGWW
WWGGWWGGGGGGWWGGGGGGGGGGWWGGGGGGGGGGGGGGWWGGWW
WWGGWWGGWWWWWWWWWWWWWWWWWWGGWWWWWWWWWWGGWWGGWW
WWGGWWGGWWWWWWWWWWWWWWWWWWGGWWWWWWWWWWGGWWGGWW
WWGGGGGGWWGGGGGGGGGGGGGGGGGGWWGGGGGGGGGGWWGGWW
WWGGGGGGWWGGGGGGGGGGGGGGGGGGWWGGGGGGGGGGWWGGWW
WWWWWWGGWWGGWWWWWWWWWWWWWWWWWWGGWWWWWWWWWWGGWW
WWWWWWGGWWGGWWWWWWWWWWWWWWWWWWGGWWWWWWWWWWGGWW
WWGGWWGGWWGGWWGGGGGGGGGGGGGGWWGGWWGGGGGGGGGGWW
WWGGWWGGWWGGWWGGGGGGGGGGGGGGWWGGWWGGGGGGGGGGWW
WWGGWWGGWWGGWWWWWWGGWWWWWWWWWWGGWWGGWWWWWWGGWW
WWGGWWGGWWGGWWWWWWGGWWWWWWWWWWGGWWGGWWWWWWGGWW
WWGGGGGGWWGGGGGGWWGGGGGGGGGGGGGGGGGGWWGGGGGGWW
WWGGGGGGWWGGGGGGWWGGGGGGGGGGGGGGGGGGWWGGGGGGWW
WWWWWWWWWWWWWWWWWWWWWWWWWWWWWWWWWWWWWWWWWWWWWW
WWWWWWWWWWWWWWWWWWWWWWWWWWWWWWWWWWWWWWWWWWWWWW